独家大碗米粉 | Exclusive Large Bowl Of Rice Noodles
猪骨汤米线 | D# Pork Bone Broth Jxrn
番茄汤米线 | D# Tomato Jxrn Soup
沙爹米线 | D# Satay Jxrn Soup
泡椒酸米线 | D# Spicy & Sour Pickled Chilies Jxrn Soup
酸菜麻辣米线 | D# Spicy Pickled Mustard Green Jxrn Soup
双椒麻辣米线 | D# Spicy Double Chilies Jxrn Soup
盐酥鸡 | Popcorn Chicken
港式叉烧云吞汤面 | Hongkong Wonton Roast Pork
咖喱鱼丸 | Curry Fish Ball
麻辣酸菜牛腩汤米线 | Spicy Beef Tendon with Pickle Mustard Green And Jiangxi Rice Noodle Soup
麻辣牛腩牛腱牛百叶汤米线 | Beef Combo Jiangxi Rice Noodle Soup
港式西多士 | Hong Kong Toast
滑蛋叉烧饭 | Scramble Egg Roasted Pork Rice
卤肉饭 | Braised Pork Belly Rice
咖喱牛腩饭 | Curry Beef Tendon Rice
炒年糕 | Stir - Fried Rice Cake
干炒黑椒火腿意粉 | Spaghetti Ham
猪肉夹饼 | Pork Flatbread
辣炒江西米线 | Stir - Fried Jiangxi Rice Noodle
甜豆浆 | Soy Milk
豉椒排骨飯 | Pork Spare Rib Bbs with Rice
大碗酸辣米線 Deluxe JXRN | Deluxe Jiangxi Rice Noodle Soup
沙茶油菜心飯 | Stir-fried Yu Choy in Sa Tsa Sauce with Rice
雙椒牛肉米線 | A#spicy Garlic Beef W /chilies, Veg & Jiangxi Rice Noodle Soup
雪菜毛豆肉絲湯米線 | A#shredded Pork W/ Salted Pmg, Edamame Jiangxi Rice Noodle Soup
时令蔬菜 | Chinese Veg
酸辣上海雲吞粉條 | Spicy & Sour Shanghai Wonton W. Ground Pork Peanut Soy Egg & Sweet Potato Noodles Soup
蕃茄鸡蛋肉末拌上海面 | B#tomato Egg Ground Pork with Shanghai Style Flour Noodle
辣泡菜午餐肉炒饭 | Kimchi Spam Fried Rice
培根鲜虾炒饭 | Bacon Shrimp Fried Rice
香辣豆干炒肉丝饭 | Pork Tofu Cilantro Rice
吉列黑椒蘑菇猪扒饭 | Pork Chop Black Pepper Mushroom Rice
椒麻鸡丁饭 | Szechuan Peppercorn Chicken Rice
香辣韭菜炒鱿鱼饭 | Squid Chives
香酥葱油鸡扒饭 | Fried Chicken 'fillet with Ginger Garlic Soy Sauce
吉列咖喱猪扒饭 | Curry Pork Chop with Rice
照烧金针肥牛盖饭 | Beef Teriyaki
酸辣清汤肥牛米线 | Spicy & Sour Beef
红烧肉末玉子豆腐饭 | Egg Tofu Gr Pork Rice
港式焗猪扒饭 | Baked Hk Style Pork Chop with Cheese & Rice
咖喱芝士肉酱焗意面 | Baked Cheese Ground Pork Pasta
芝士咖喱鸡扒焗饭 | Baked Cheese Curry Chicken Rice
西兰花鸡片饭 | Chicken with Broccoli Rice
时菜鸡片饭 | Chicken with Seasonal Veg Rice
墨西哥椒炒鸡柳饭 | Chicken with Jalapeno Rice
葱爆鸡柳饭 | Chicken with Scallion Rice
鸡肉番茄蛋盖饭 | Scrambled Egg with Chicken
豉椒鸡片饭 | Chicken with Blackbean Sauce Rice
黑椒鸡扒饭 | Chicken with Black Pepper Sauce Rice
照烧鸡扒饭 | Chicken with Teriyaki Sauce Rice
芝麻鸡饭 | Sesame Chicken Rice
左宗棠鸡饭 | General Tso's Chicken Rice
葱爆牛柳丝饭 | Beef with Scallion Rice
酸菜牛柳丝饭 | Beef with Pickled Mustard Green Rice
西兰花牛肉饭 | Beef with Broccoli Rice
蘑菇牛肉饭 | Beef with Mushroom Rice
墨西哥椒炒牛肉饭 | Beef with Jalapeno Rice
牛肉番茄蛋盖饭 | Scrambled Egg with Beef And Tomato Rice
豉椒牛肉饭 | Beef with Blackbean Sauce Rice
黑椒牛柳丝饭 | Beef with Black Pepper Sauce Rice
时菜牛肉饭 | Beef with Seasonal Vegetable
豆腐牛肉饭 | Beef with Tofu in Oyster Sauce Rice
五香薯仔牛柳饭 | 5 Spices Potato Beef Rice
鱼香肉碎茄子饭 | Gr Pork Eggplant Rice
墨西哥辣椒炒肉丝饭 | Pork with Jalapeno Rice
鱼香烘蛋饭 | Scramble Egg Ground Pork Rice
酸菜肉丝饭 | Pork Pickled Mustard Green Rice
榨菜肉丝饭 | Pork with Preserved Mustard Green Rice
蘑菇肉片饭 | Pork with Mushroom Rice
时菜肉片饭 | Pork with Seasonal Veg Rice
麻婆豆腐饭 | Ma Po Tofu Rice
鱼香肉碎豆腐饭 | Ground Pork Tofu Rice
豉椒茄子鱼片饭 | Fish Eggplant in Black Bean Sauce Rice
时菜鲜鱿饭 | Squid with Seasonal Vegetable Rice
酸菜鱿鱼饭 | Squid with Pickled Mustard Green Rice
西兰花鱼片饭 | Fish with Broccoli Rice
西兰花虾仁饭 | Shrimp with Broccoli Rice
时菜虾仁饭 | Shrimp with Seasonal Veg Rice
虾仁番茄蛋盖饭 | Scrambled Egg with Shrimp Rice
黑椒虾仁饭 | Shrimp with Black Pepper Sauce Rice
豉汁鲜鱿饭 | Squid with Black Bean Sauce Rice
红烧牛肉面 | Braised Beef Noodle Soup
云吞汤面 | Pork And Shrimp Wonton Noodle Soup
炸猪扒汤面 | Fried Pork Chop Noodle Soup
清炖牛腩汤面 | Steamed Beef Tendon Noodle Soup
猪肉饺子汤面 | Pork Dumpling Noodle Soup
炸鸡腿汤面 | Fried Chicken Leg Noodle Soup
炸酱面 | Cha Jang Mein
热麻酱面 | Hot Sesame Noodle
酸菜鱼片汤米粉 | Fish with Pickle Mustard Green Rice Noodle Soup
冷麻酱面 | Cold Sesame Noodle
榨菜肉丝汤米粉 | Pork Preserved Mustard Green Rice Noodle Soup
蘑菇蔬菜炒面 | Stir - Fried Noodles with Veg And Mushroom
叉烧炒面 | Stir - Fried Noodles with Roast Pork
鸡肉炒面 | Stir - Fried Noodles with Chicken
炸鸡柳炒面 | Stir - Fried Noodles with Crispy Tender Chicken
牛肉炒面 | Stir - Fried Beef Noodle
炸猪扒炒面 | Stir - Fried Noodles With Fried Pork Chop
炸鸡腿炒面 | Stir - Fried Noodles With Fried Chicken Leg
虾仁炒面 | Stir - Fried Noodles With Shrimp
豉椒炒河粉 | Stir - Fried Hofun With Black Bean Sauce
星洲炒米粉 | Singapore Stir - Fried Rice Noodles
厦门炒米粉 | Amoy Stir - Fried Rice Noodles
泰式炒河粉 | Stir-fried Thai Noodles
沙爹炒河粉 | Satay Stir-fried Hofun
腐皮炒青江菜饭 | Chinese Veg with Tofu Skin Rice
罗汉斋饭 | Mix Veg with Mushroom Rice
鱼香豆腐饭 | Tofu Garlic Sauce Rice
榨菜炒豆干饭 | Tofu Preserved Mustard Green Rice
墨西哥椒炒豆干饭 | Tofu with Jalapeno Rice
红烧茄子豆腐饭 | Tofu with Chinese Eggplant Rice
鱼香茄子豆腐饭 | Tofu Eggplant in Garlic Sauce Rice
红烧茄子饭 | Chinese Eggplant Rice
腐皮炒西兰花饭 | Tofu Skin with Broccoli Rice
牛肉炒饭 | Beef Fried Rice
炸猪扒炒饭 | Fried Pork Chop Fried Rice
鸡肉炒饭 | Chicken Fried Ricw
叉烧炒饭 | Roast Pork Fried Rice
香酥鸡扒炒饭 | Crispy Tender Chicken Fried Rice
蘑菇蔬菜炒饭 | Veg And Mushroom Fried Rice
炸鸡翼炒饭 | Fried Chicken Wing Fried Rice
本楼炒饭 | House Special Fried Rice
虾仁炒饭 | Shrimp Fried Rice
腐皮青菜炒饭 | Fried Tofu Skin with Chinese Veg Fried Rice
炸鸡腿炒饭 | Fried Chicken Leg Fried Rice
皮蛋瘦肉粥 | Pork And Thousand Years Egg Congee
红烧牛肉粥 | Beef Congee
生菜鱼片粥 | Fish Congee
鲜虾粥 | Shrimp Congee
紅燒牛肉粥 | Braised Beef Congee